0 0 0 0 0 0 0 0 0 0 0 0 0 0 0 0
0 0 0 0 0 0 0 0 0 0 0 0 0 0 0 0
0 0 0 0 0 0 0 0 0 0 0 0 0 0 0 0
0 0 0 0 0 0 0 0 0 0 0 0 0 0 0 0
0 0 0 0 0 0 0 0 0 0 0 0 0 0 0 0
2 2 9 9 2 2 2 2 2 2 2 2 2 2 2 2
2 2 10 10 2 2 2 2 2 2 2 2 2 2 2 2
2 2 2 2 1 2 2 2 2 2 2 2 2 2 2 2
0 0 5 5 6 8 9 9 13 13 2 2 2 2 2 2
2 2 3 3 7 7 10 10 14 14 2 2 2 2 2 2
2 2 2 2 2 2 2 2 2 2 2 2 2 2 2 2
2 2 2 2 2 2 2 2 2 2 2 2 2 2 2 2
2 2 4 2 2 1 2 2 2 12 12 2 2 2 2 2
0 0 0 0 0 0 0 0 0 11 11 0 0 0 0 0